5

———————
|b|o __|
|b||L—-|
|b||ob |
|bJo-o |
|o|-b—-|
————————